MMMMMMMMMMMMMMMMMMMMMMMMMMMMMMMMMMMMMMMM
M                  M                  MM
M MMMMMMM MMMMMMMM M MMMMMMMM MMMMMMM MM
M MMMMMMM MMMMMMMM M MMMMMMMM MMMMMMM MM
MFMMMMMMM MMMMMMMM M MMMMMMMM MMMMMMMFMM
M MMMMMMM MMMMMMMM M MMMMMMMM MMMMMMM MM
M                                     MM
M MMMMMMM MMMMM MMMMMMM MMMMM MMMMMMM MM
M MMMMMMM MMMMM MMMMMMM MMMMM MMMMMMM MM
M    MMMM    MM    M    MM    MMMM    MM
M MM      MM MMMMM M MMMMM MM      MM MM
M MMMMMMM MM MMMMM M MMMMM MM MMMMMMM MM
M MM         MMMMM M MMMMM         MM MM
M    MMMM MM       P       MM MMMM    MM
MMMMMMMMM MM MM MMM MMM MM MM MMMMMMMMMM
MMMMMMMMM    MM M     M MM    MMMMMMMMMM
MMMMMMMMMMMM MM M     M MM MMMMMMMMMMMMM
MMMMMMMMMMMM MM M     M MM MMMMMMMMMMMMM
MMMMMMMMMMMM MM MMM MMM MM MMMMMMMMMMMMM
MMMMMMMMMMMM               MMMMMMMMMMMMM
MMMMMMMMMMMM MM MMMMMMM MM MMMMMMMMMMMMM
MMMMMMMMMMMM MM MMMMMMM MM MMMMMMMMMMMMM
MMMMMMMMMMMM MM         MM MMMMMMMMMMMMM
MMMMMMMMMMMM MM MMM MMM MM MMMMMMMMMMMMM
MMMMMMMMMMMM MM MMM MMM MM MMMMMMMMMMMMM
M                                     MM
M MMMMMMM MM MMMMMMMMMMMMM MM MMMMMMM MM
M MMMMMMM MM MMMMMMMMMMMMM MM MMMMMMM MM
M      MM MM      MMM      MM MM      MM
MMMMMM MM MM MMMM MMM MMMM MM MM MMMMMMM
MMMMMM MM MM MMMM MMM MMMM MM MM MMMMMMM
M      MM MM MMMM MMM MMMM MM MM      MM
M MMMM MM MM               MM MM MMMM MM
M MMMM MM    MMMMMMMMMMMMM    MM MMMM MM
MFMMMM MMMMM MMMMMMMMMMMMM MMMMM MMMMFMM
M MMMM            MMM            MMMM MM
M MMMM MMMMMMMMMM MMM MMMMMMMMMM MMMM MM
M MMMM MMMMMMMMMM MMM MMMMMMMMMM MMMM MM
M                                     MM
MMMMMMMMMMMMMMMMMMMMMMMMMMMMMMMMMMMMMMMM
MMMMMMMMMMMMMMMMMMMMMMMMMMMMMMMMMMMMMMMM